1111111111111
1P0111E000C01
10000C0000001
1111111111111
