1111111111111
1PE1110001C01
10000C0001111
1111111111111
