111111111111111111
1000P0C000000001E1
100000000000000011
111111111111111111