111111111111111111111111
1P0000000000000000000001
1100C000000C000000000001
10000111000000C000000001
100000000000000000C00001
10000C0000E0000100000001
1000000000000001000000C1
111111111111111111111111
