11111111111111
1P00110000C001
10000C00000001
10000C00000001
100C00000C0001
11111111111111