111111111111
1P0000000001
1011111110101
1C0000010001
1010111010101
1C00000E0001
111111111111