1111111111111
1P0011E000C01
1000000000001
1111111111111
